S  #######
      #  #
####  #  #
#        #
#  ####  #
#  #      
#######  E