S  ############################
         #  #           #     #
#  #  ####  #  #######  #  ####
#  #     #        #           #
#  #######  #  ##########  ####
#           #  #  #  #     #  #
#  ####  ####  #  #  ####  #  #
#  #        #  #  #     #     #
#  #  #######  #  #  #  #  ####
#  #        #        #  #  #  #
#  ####  ####  ##########  #  #
#     #  #              #  #  #
##########  ####  #  ####  #  #
#     #     #     #  #  #  #  #
####  #######  #######  ####  #
#     #  #                 #  #
#  ####  ####  ##########  #  #
#  #              #     #     #
#  #  ####  ####  #  ####  #  #
#     #     #           #  #   
############################  E