S  #######
         #
#######  #
#        #
#  #######
#         
#######  E